2 0 0 6 6 6 6 6 6 6 6 6 6 6 6 2
4 0 7 0 0 0 0 0 0 0 0 0 0 0 0 3
4 0 7 0 0 0 0 0 0 0 0 0 0 0 0 3
4 0 7 0 0 0 0 0 0 0 0 0 0 0 0 3
4 0 0 7 7 7 7 7 7 7 0 0 0 0 0 3
4 0 0 7 7 7 7 7 7 7 0 0 0 0 0 3
4 0 0 7 7 7 7 7 7 7 0 0 0 0 0 3
4 0 0 0 0 0 0 0 0 0 0 0 0 0 0 3
2 5 5 5 5 5 5 5 5 5 5 5 5 5 5 2